1111111111111111
10000000000000E1
1000000C00000001
100P000000000001
1111111111111111