11111111111111111111
1P0000100000000000P1
10000010000000000001
10000111100000000001
10000000000000000001
10000001111110000001
10000001000000000001
11111001111111110001
1E00000000001C000001
11111111111111111111