11111111111111111111
100000100000000000P1
10000010000000000001
10000111100000000001
10000000000000000001
10000001111110000001
10000001000000000001
11111001111111110001
10EE000000001C000001
11111111111111111111