1111111111111111
10001000000000E1
1000100C00000001
100P100000000001
1111111111111111